111111111111111
1P0000000000001
101111101111101
101CE0000000001
101111101111111
100000C00000001
111111111111111
