1111111111111111111111111111111111111111111111111111111111111111
1P0000000C00001111111111111110000000000C000011111111111111111111
1C00001111100011111111111111110000001111111111111111111111111111
1000001111100000000000000000111000000000000001111111111111111111
1000000000000000C000011111111100000C0000011111111111111111111111
1000C0000111111110000111111111000E011111111111111111111111111111
1000000000000000000000000000000000000000000000111111111111111111
1111111111111111111111111111111111111111111111111111111111111111