111111
1P0001
1C1E01
100001
111111